11111111111
1C0000000C1
10001E10001
10001110001
1C000P000C1
10000000001
1C0000000C1
11111111111
