111111111
1P0000001
100000001
1H0000001
1C00C00C1
1000000H1
1C00C00C1
1H0000001
1000000E1
111111111