111111111111111
1P00000CCCC0001
100000000000001
111111111111C11
1CV00V00V001001
100V00V00V00101
1000V00V00V0001
1C1111111111101
1H010001000V1V1
10H101010100111
1H01010101000C1
1C00010001V01E1
111111111111111
